NO ./path_to_the_north_texture.xpm
SO ./path_to_the_south_texture.xpm
WE ./path_to_the_west_texture.xpm
EA ./path_to_the_east_texture.xpm


F 220,100,255
C 225,30,225











1111111111111111111111111111111111
111100000000W00101010001
11111111111111111111111111111

1111111111111111111111111
111111111111111111111111111
111111 111   11111111111101111
1111111111111111111111111111111
