
NO ./path_to_the_north_texture.xpm
SO ./path_to_the_south_texture.xpm
WE ./path_to_the_west_texture.xpm
EA ./path_to_the_east_texture.xpm


F 220,100,255
C 225,30,225

















1111111 111111111111111111111111111
1111111111011111111111111111 1
11111111111           1111111111111


111111111111111111111111    11
111100000000000101010001
111111111111111111W11111111  11
111111 111  1111111111110111101
11111111111111111 1111111 11111111
1111111111111111111111111111111





                                

                                             