NO ./path_to_the_north_texture.xpm
SO ./path_to_the_south_texture.xpm
WE ./path_to_the_west_texture.xpm
EA ./path_to_the_east_texture.xpm
F 220,100,0

C 225,30,0









11111111111111111111111111111111111
1111100000000000000010101001
111111111111111111111111111

1111111111111111111111111
1111111111111111111111111111
111111 111   1111110111111111111
1111111111111111111111111111111
